+-+-+-+-+-+-+-+-+-+-+
S           |   |   |
+ +-+-+-+-+ + + +-+ +
|   |   |   | | |   |
+ + +-+ + +-+ + + +-+
| | |   |   | |     |
+ + + +-+-+ + +-+ + +
| |   |   | | |   | |
+ +-+-+ + + + + +-+ +
| |     | | | | |   |
+ + +-+-+ + + + +-+-+
| |   |   | | |   | |
+-+-+-+ +-+ + +-+ + +
|       |   |   | | |
+ +-+ +-+ +-+-+-+ + +
|   |     |   |     |
+-+ +-+-+-+ + + + +-+
|   |     | |   |   |
+ +-+ + + +-+ +-+-+ +
| F   | |     |      
+-+-+-+-+-+-+-+-+-+-+