+--+--+--+--+--+--+--+--+--+--+--+--+--+--+--+
S     |        |     |        |     |        |
+--+  +  +--+  +  +  +--+--+  +  +  +  +--+  +
|     |     |  |  |           |  |     |     |
+  +--+--+  +  +  +--+--+--+--+  +--+--+  +--+
|        |  |                 |        |  |  |
+  +--+--+  +--+  +--+--+  +--+--+--+  +  +  +
|        |  |     |        |           |     |
+--+--+  +  +--+--+  +--+--+  +  +  +--+--+  +
|        |  |     |     |     |  |  |        |
+--+--+  +  +  +  +--+  +  +--+--+  +  +--+--+
|        |     |  |     |     |     |  |     |
+  +--+--+--+--+  +  +--+--+--+  +--+  +--+  +
|  |           |  |  |     |     |  |        |
+  +  +--+--+  +  +  +  +  +  +--+  +--+--+--+
|  |  |     |     |  |  |        |     |     |
+  +  +  +--+  +--+  +  +--+  +  +--+  +  +  +
|  |  |        |  |        |  |        |  |  |
+  +  +--+--+  +  +--+--+--+  +--+  +--+  +  +
|  |  |     |     |           |  |        |  |
+  +  +  +--+--+--+  +--+--+  +  +--+--+--+  +
|     |              |  |     |     |        |
+  +--+  +--+--+--+--+  +  +--+--+  +  +--+--+
|     |     |     |     |     |  |  |  |     |
+--+--+--+  +  +  +  +  +--+  +  +  +  +  +  +
|        |     |     |     |  |     |  |  |  |
+  +--+  +--+--+--+--+  +  +  +  +--+  +  +  +
|  |  |              |  |  |  |  |     |  |  |
+  +  +--+--+--+--+  +--+  +--+  +  +  +  +  +
|     |                          |  |     |  F
+--+--+--+--+--+--+--+--+--+--+--+--+--+--+--+