+----+----+----+----+----+----+----+----+----+----+----+----+----+----+----+
               |         |         |    |                                  |
               |         |         |    |                                  |
               |         |         |    |                                  |
               |         |         |    |                                  |
+----+----+    +----+    +----+    +    +    +----+----+----+    +----+    +
|    |         |         |              |         |              |         |
|    |         |         |              |         |              |         |
|    |         |         |              |      S  |              |         |
|    |         |         |              |         |              |         |
+    +    +----+    +----+    +    +----+----+    +----+----+----+    +----+
|              |    |         |              |         |         |    |    |
|              |    |         |              |         |         |    |    |
|              |    |         |              |         |         |    |    |
|              |    |         |              |         |         |    |    |
+    +----+----+    +    +----+----+----+    +----+    +    +    +    +    +
|    |              |         |         |              |    |         |    |
|    |              |         |         |              |    |         |    |
|    |              |         |         |              |    |         |    |
|    |              |         |         |              |    |         |    |
+    +    +    +    +----+    +    +    +----+----+----+----+----+----+    +
|         |    |         |    |    |    |         |              |         |
|         |    |         |    |    |    |         |              |         |
|         |    |         |    |    |    |         |              |         |
|         |    |         |    |    |    |         |              |         |
+----+----+    +----+    +    +    +    +    +    +    +----+    +    +    +
|              |    |    |    |    |         |         |         |    |    |
|              |    |    |    |    |         |         |         |    |    |
|              |    |    |    |    |         |         |         |    |    |
|              |    |    |    |    |         |         |         |    |    |
+    +----+----+    +    +    +    +----+----+----+----+----+    +----+    +
|    |         |    |    |    |         |         |              |         |
|    |         |    |    |    |         |         |              |         |
|    |         |    |    |    |         |         |              |         |
|    |         |    |    |    |         |         |              |         |
+    +    +    +    +    +    +----+    +----+    +    +----+----+    +    +
|         |         |              |              |    |         |    |    |
|         |         |              |              |    |         |    |    |
|         |         |              |              |    |         |    |    |
|         |         |              |              |    |         |    |    |
+    +----+----+----+----+----+----+    +    +----+    +    +    +    +    +
|              |                   |    |         |         |    |    |    |
|              |                   |    |         |         |    |    |    |
|              |                   |    |         |         |    |    |    |
|              |                   |    |         |         |    |    |    |
+----+----+    +    +----+----+    +----+----+    +----+----+    +    +    +
|              |         |         |         |    |              |    |    |
|              |         |         |         |    |              |    |    |
|              |         |         |         |    |              |    |    |
|              |         |         |         |    |              |    |    |
+    +----+----+----+    +    +----+    +    +    +----+    +----+    +    +
|                   |    |    |         |         |         |         |    |
|    F              |    |    |         |         |         |         |    |
|                   |    |    |         |         |         |         |    |
|                   |    |    |         |         |         |         |    |
+----+----+----+    +----+    +    +----+----+----+    +----+----+----+    +
|              |              |                   |    |              |    |
|              |              |                   |    |              |    |
|              |              |                   |    |              |    |
|              |              |                   |    |              |    |
+    +----+----+----+    +----+----+----+----+    +    +    +----+    +    +
|    |                             |              |         |              |
|    |                             |              |         |              |
|    |                             |              |         |              |
|    |                             |              |         |              |
+    +    +----+----+----+----+    +    +----+----+----+----+    +----+----+
|                   |         |         |         |         |              |
|                   |         |         |         |         |              |
|                   |         |         |         |         |              |
|                   |         |         |         |         |              |
+----+----+----+    +    +----+    +----+    +    +----+    +----+----+    +
|                   |                        |              |               
|                   |                        |              |               
|                   |                        |              |               
|                   |                        |              |               
+----+----+----+----+----+----+----+----+----+----+----+----+----+----+----+
