+-+-+-+-+-+-+-+-+-+-+-+-+-+-+-+
    |     |   |   |     |     |
+-+ + +-+ +-+ + + +-+-+ + +-+ +
|   |   | |   | |   |   | |   |
+ +-+-+ + + + +-+-+ + +-+ + +-+
|     | | | | |     |     | | |
+-+-+ + + + +-+ +-+-+-+-+-+ + +
|   | | | |   |   |       | | |
+-+ + +-+ +-+ +-+ + +-+-+ + + +
|   |   | | |   |     |   | | |
+ +-+-+ + + +-+ + +-+ + +-+ + +
|       | |     | |   |   | | |
+-+-+ +-+ + +-+-+-+ +-+-+ + + +
|       | | |   |   |     | | |
+ +-+-+-+ + + + + +-+ +-+-+ + +
|   |       | | |   |     |   |
+-+ +-+-+ +-+-+ +-+ +-+-+ + +-+
| S |   |   |   |       |     |
+ +-+ + +-+ + +-+-+-+ +-+-+ + +
|     |       |         |   | |
+ +-+-+ +-+ +-+ +-+-+-+ + +-+-+
|   |   |       |     | | |   |
+-+-+ +-+-+-+-+-+ +-+ + +-+ + +
|       |   |   | |   | |   | |
+ +-+-+ + +-+ + + +-+ + + +-+ +
|   |   |     | | |   |     | |
+-+-+ +-+-+-+-+ + + +-+-+-+-+ +
|     |     | | | |           |
+ +-+-+ +-+ + + + + +-+-+-+-+-+
|       |   |     |           F
+-+-+-+-+-+-+-+-+-+-+-+-+-+-+-+