+--+--+--+--+--+--+--+--+--+--+--+--+--+--+--+
S     |     |           |        |  |        |
+  +  +--+  +  +--+--+  +  +--+  +  +  +--+  +
|  |        |     |  |     |  |        |     |
+  +--+--+--+--+  +  +--+--+  +--+--+  +  +--+
|  |                 |     |  |        |     |
+  +--+--+--+--+  +--+  +  +  +--+--+--+--+  +
|  |           |     |  |  |  |        |     |
+  +  +--+  +--+--+  +  +--+  +  +--+  +  +--+
|     |     |        |           |  |     |  |
+--+--+  +--+  +  +--+--+--+  +--+  +--+--+  +
|        |     |     |  |     |     |        |
+  +--+--+--+--+--+  +  +  +--+  +--+  +--+--+
|        |           |  |     |        |     |
+--+--+  +  +--+--+--+  +  +  +  +--+--+  +--+
|        |  |     |        |  |  |           |
+  +--+--+  +  +  +  +--+--+--+  +  +--+--+  +
|  |     |  |  |     |           |  |        |
+  +  +  +  +  +--+--+  +--+--+--+  +  +  +--+
|  |  |     |  |  |     |     |     |  |  |  |
+  +  +--+--+  +  +  +--+  +  +--+  +  +  +  +
|     |     |  |           |  |     |  |  |  |
+--+--+  +  +  +  +  +--+--+  +  +--+  +  +  +
|        |  |     |  |        |  |     |     |
+  +--+--+--+--+--+  +  +--+--+  +  +--+--+--+
|              |     |  |     |  |     |     |
+--+  +--+  +  +  +--+  +  +--+  +--+  +  +  +
|  |     |  |     |     |     |     |  |  |  |
+  +--+  +  +--+--+  +--+--+  +--+  +  +--+  +
|        |        |                 |        F
+--+--+--+--+--+--+--+--+--+--+--+--+--+--+--+
