+-+-+-+-+-+-+-+-+-+-+-+-+-+-+-+-+-+-+-+-+-+-+-+-+-+-+-+-+-+-+-+-+-+-+-+-+-+-+-+-+-+-+-+-+-+-+-+-+-+-+
S     |   |   |   |   |   |     |     |     |   |     |   |   |     |       |     |       |   |     |
+ +-+ +-+ + + + + +-+ + + + +-+ + +-+ + + + + + +-+ + +-+ + + + +-+ + +-+-+ + +-+ +-+ +-+ + + + +-+ +
|   |   | | |   |       |   |   | | | | | |   |     |   |   | |   | | |     | |     | |   | |   |   |
+-+ +-+ + + +-+-+-+-+-+-+-+-+ +-+ + + +-+ +-+-+ + +-+-+ + +-+ +-+ + + + +-+-+ + +-+ + +-+-+ +-+-+ +-+
|   |   |   |               | |   |   |     |   | |     |   |     |   | |     | |   |     | |   |   |
+ +-+ + + +-+ +-+-+-+-+-+-+ + + +-+ +-+ + + +-+-+-+ +-+-+ +-+-+-+-+ +-+ + +-+-+ + +-+-+-+ + +-+ +-+ +
| |   |   |   |       |     |   |   | | | |   | |   |   | |     |   |   |   |   | |   |   |     |   |
+ +-+-+-+-+ +-+ +-+-+ +-+ +-+ +-+ +-+ + +-+-+ + + + + + + + +-+ + +-+ +-+-+-+ +-+ +-+ + +-+-+-+ + +-+
|   |   |   |   |   |   |   | | | |       |   |   | | |   | | |   | | |       |           |     | | |
+-+ +-+ + + + +-+-+ +-+ +-+ + + + +-+-+-+ + + +-+-+-+ +-+-+ + +-+-+ + +-+-+ +-+ +-+-+-+-+-+ + +-+ + +
| | |   | |   |     |   | |   | | |   |   | |   |   |     |       | |     | |   |   |   |   |   |   |
+ + + +-+ +-+-+ +-+-+ +-+ +-+-+ + + + + +-+ +-+ +-+ +-+-+ +-+-+-+-+ +-+-+ + +-+-+ + + + + +-+ + +-+-+
|   | |   |       |       |   | |   |   | | |   |   |           |       |   |     | | |   |   | |   |
+ +-+ + +-+-+-+-+ +-+-+ +-+ + + +-+ +-+-+ + + +-+ +-+ +-+-+-+-+ + + +-+-+-+-+ +-+-+ +-+ +-+ +-+ + + +
| |   | |       | |         | | |       |   |   |   | |   |     | | |   |     |     |   | |   | | | |
+ + +-+ + +-+-+-+ + +-+ +-+-+ + +-+-+-+ +-+-+-+ +-+ + + + +-+-+ + + + + + +-+-+ +-+-+ +-+ +-+ + +-+ +
| |   |   |     |   |   |     |     |   |     |     | | |   |   | |   |   |     |     |   |   |     |
+ +-+ +-+-+-+ + +-+-+ + + +-+-+-+-+ + +-+ + + +-+ +-+-+ +-+ + +-+ +-+-+-+-+ +-+-+-+ +-+ + +-+-+-+-+ +
|   |     |   | |     | |   |     |   |   | |   | |   |   | | | |   |     |         |   |       |   |
+ +-+-+-+ + +-+ +-+-+-+ +-+ +-+-+ +-+-+ +-+ +-+ + + + +-+-+ + + +-+ +-+-+ +-+ +-+-+-+ +-+-+-+-+ +-+ +
|   |     |   |       |   |   |   |   | |   | | | | |   |   | |       |   | |   |     |   |   |   | |
+-+ + +-+-+-+ +-+-+-+ +-+ +-+ + +-+-+ + + +-+ + +-+ +-+ + +-+ +-+-+-+ + +-+ +-+ + +-+-+ +-+ + +-+ +-+
|   | |       |     |       | |   |   | |     | |     |     | |   |   |   |   | | |   |   | |   |   |
+ +-+ +-+ +-+-+ + +-+-+-+ + + + + + +-+ +-+-+-+ + +-+-+-+-+-+ + + + +-+ + +-+ + + + + +-+ + +-+ +-+ +
| |   |   |     | |     | | |   | |   |   |   | | |     | |   | | | |   |   |   | | | |     |     | |
+ + +-+ +-+ +-+-+ + +-+ +-+ +-+-+-+-+ +-+ + + + + + +-+ + + +-+ +-+ + +-+-+ +-+-+ +-+ + +-+-+ +-+ + +
| | |   |   | |     |   |   |   |     |   | |   | | |   |   |   |   | |   | |       | |     | | |   |
+ + + +-+ +-+ + +-+-+-+-+ +-+ + + +-+-+ +-+ +-+-+ + + +-+ +-+ +-+ +-+ + + +-+ +-+-+ + +-+-+ + + +-+-+
|   | |     | |   |   |       | | |     |         | |     |   |   |   | |     | |   |   |   | |   | |
+-+-+ + +-+ + +-+ + + +-+-+-+-+ + + +-+-+ + +-+-+-+ +-+-+-+ +-+ +-+ +-+ +-+-+ + + +-+-+ + +-+ +-+ + +
|   | |   | | |   | |     |   | | | |   | |   |   |   |       |   | |       | |   |   |   |   |   | |
+ + + +-+ +-+ + +-+ +-+-+ + + +-+ + + +-+ +-+ + + +-+ + +-+-+ +-+ + +-+-+-+ + +-+-+ + +-+-+ +-+ +-+ +
| |   | | |   | | |   |   | |         |   |   | |       |   |               |   |   |     |   | |   |
+ +-+-+ + + +-+ + +-+ + +-+ +-+-+-+ +-+ +-+-+-+ +-+-+-+-+ +-+-+ + + +-+-+-+-+-+ + +-+-+-+ +-+ + + +-+
|   |     |     |     | |   |     | |   |   | |       | | |   | | |           |   |     | |   | |   |
+-+ + +-+ +-+-+ +-+-+-+ +-+-+ +-+ + + +-+-+ + +-+-+-+ + + + +-+ + +-+-+-+-+-+ +-+-+ +-+ + + +-+ +-+ +
|   |   | |   |   |   | |   | |   | |       |         | | |     | | |   |     |   | | |   |   | |   |
+ +-+-+-+ + +-+ + + + + + + +-+ +-+ +-+-+-+-+ +-+ +-+-+ + +-+-+-+ + + +-+ +-+-+ + + + +-+-+-+ + + + +
| |     |   |   | | | | | |       | |   |       | |           | | | |     |   | | | |       |     | |
+ +-+-+ +-+ + +-+-+ + + + + +-+ + + + + + +-+-+-+ + +-+-+-+-+ + + + +-+-+-+ + + +-+ + +-+-+ +-+ +-+-+
|     |   | |     | |   | | | | | |   | | | |     | |       | |     |     | |   |   | |   | |       |
+-+ + +-+ +-+-+-+ + +-+-+ + + + + +-+-+ + + + +-+-+ + +-+-+ + +-+ +-+ +-+ + +-+-+ +-+ + +-+ +-+-+-+ +
| | |   |       | |   |   |   | |         | |   |   | |     | | |   | | | | |   |   | |     |   |   |
+ + +-+-+-+-+ + + +-+ +-+-+-+-+ +-+-+-+ +-+ + + +-+-+ + + +-+ + +-+ + + + + +-+ +-+ + +-+-+-+ + +-+-+
| | |         |     |   |       |     |   |   | |   | | | | |     |   |   |   |       |       |     |
+ + + +-+-+-+-+-+-+ + + + +-+-+-+-+-+ +-+ +-+-+-+ + + +-+ + +-+-+ +-+-+ +-+-+ +-+-+ +-+ +-+-+-+-+ + +
| | |       | |   | | |   |       | | | | |   |   | |   |     | |       |   |           | |   |   | |
+ + +-+-+-+ + + + + + +-+-+ +-+-+ + + + + + + + + + +-+ +-+-+ + +-+-+ +-+ +-+-+-+-+ +-+-+ + +-+ +-+ +
|   |     |     | | |   | | |   |   |   | | | | | | | | |   | |     | |   |         |     |     |   |
+ +-+ +-+ +-+-+-+-+ +-+ + + + +-+-+ +-+ + + + + +-+ + + + + + +-+-+ + + +-+ +-+ +-+-+ +-+-+-+-+-+-+-+
|   |   |     |     |   | | |       |   |   |   |   | |   | |   | |   |       |     | |   |         |
+-+ +-+ +-+-+ + +-+-+ +-+ + +-+-+-+-+ +-+-+-+-+-+ +-+ +-+-+-+-+ + +-+-+-+-+-+ +-+-+ + + + +-+-+-+-+ +
|   |   |     | |     |   | | |     |         |   |   |     |   |   |       | |     |   |           |
+ +-+ +-+ +-+-+ +-+ +-+ +-+ + + +-+ +-+-+-+-+ + +-+ +-+ +-+ + +-+ + + +-+-+ +-+ +-+-+ +-+-+-+ +-+-+ +
|   |   | |   | |   |   |     |   | | |     |   |     | |   |   | | |     |   |       |     | |     |
+-+ +-+ + + + + + +-+ +-+ +-+-+-+ + + + +-+ +-+-+-+ +-+ + +-+-+ + + + +-+ +-+ +-+-+-+-+ +-+ +-+ +-+-+
|   |   | | |   |     |       |   |   | |         |   | |       | | | | | |   |       |   |     |   |
+ +-+-+ + + +-+-+-+ +-+ +-+-+ +-+-+-+ +-+ +-+-+-+ +-+ + +-+-+-+-+ + + + + + +-+ + +-+-+-+ +-+-+-+ +-+
| |     |   |           |   |     |   |     |     |   |     |   | |   |   |   | |   |     |   | |   |
+ + +-+ +-+-+-+ + +-+-+-+ + +-+-+ +-+ + +-+ +-+-+-+ + +-+-+ +-+ + +-+-+-+-+-+ + +-+ + +-+-+ + + +-+ +
|   |   |     | |   |   | |     |   | | |   |   |   |       |   | |           | |   | |     | |     |
+-+-+ +-+-+ + + +-+ + + + + +-+-+-+ + + + +-+ + + +-+ +-+-+-+ +-+ +-+-+-+-+-+-+ + +-+ + +-+-+ +-+ +-+
|   | |     | |   | | |   |     |     | | |   | | |   |     |   | |   |     |   |   | | | |       | |
+ + + + +-+-+ +-+-+ + +-+-+-+-+ + + +-+ + +-+-+ + + +-+ + +-+-+ + + + + +-+ + +-+-+-+ + + + + +-+ + +
| | |   |   |     | |   |   |   | | |   |     | | |     |         | | | |   | |       | |   |   |   |
+ + +-+-+ +-+-+-+ + +-+ +-+ + +-+ + + +-+-+-+ + + +-+ +-+-+-+-+ +-+ +-+ + +-+ +-+ +-+-+ +-+-+ + +-+-+
| |     |   |     |   |   |   |   |   |   |     | |   |         |       |   | |   |   | |     | |   |
+ +-+-+ +-+ + +-+-+-+ +-+ +-+-+ +-+-+-+ + + +-+-+ +-+-+ +-+ +-+-+-+-+-+ +-+ + + +-+ + + + +-+-+ + + +
|     |       |         |       |   |   | | |   |   |   |   |     |     |     |     |   | |   |   | |
+ +-+ + +-+-+-+ +-+-+-+-+-+-+-+-+-+ + +-+ + +-+ +-+ + +-+ +-+-+ + +-+-+-+-+-+ + +-+-+-+-+ + + +-+-+-+
|   | |         |           |   |   | |   |   | |   |   |       |     | |     | |   |     | |       |
+-+-+ +-+-+-+-+-+-+-+-+-+-+ +-+ + +-+ + +-+-+ + + +-+-+ +-+-+-+-+-+-+ + + +-+-+ + +-+ +-+-+-+ +-+-+ +
|   |   |   |       |   |   |   | |   | |     | | |   |     | |       |   |   | |   | |       |     |
+ + +-+ + + +-+-+-+ + + + +-+ +-+ + +-+-+ + +-+ + +-+ +-+-+ + + + +-+-+ +-+ + + +-+ + + +-+-+-+ +-+-+
| |     | |   | |   | | | |   |     |     |   |     |     | | | |   |   |   |   |     | |   | |   | |
+ +-+-+-+ +-+ + + + + +-+ + +-+ + +-+ +-+-+-+ +-+-+ +-+-+ + + + +-+ + +-+ +-+-+-+-+-+ + + + + +-+ + +
|   |       |   | | | |   |   | | |   |   |   |     |   | |   |   |   |   |   |   | |     | |   |   |
+-+ + +-+-+-+-+ +-+ + + +-+-+ +-+ + +-+ + + +-+ +-+-+-+ + +-+-+-+ +-+-+ +-+ + +-+ + +-+ +-+ +-+ +-+-+
|   |     |   |   | |   |   |   | |   | | | |   |   |   | |   |   |     |   |       |   | |   |     |
+ +-+-+-+ + + +-+ + + +-+ + +-+ + + +-+ + +-+ +-+ + + +-+ + + + +-+ +-+-+ +-+-+-+-+-+ +-+ +-+ + +-+ +
| |     |   |   |     |   |     | |     |         | |   | | | | | | |   |     |   |   | | |   | |   |
+ + +-+ +-+-+-+ +-+ + + +-+-+ +-+ +-+-+-+-+-+-+-+-+-+-+ + + + + + + + + +-+-+ + + +-+-+ + + +-+ + +-+
|   | | |       | | | | |       |     |       | |     | |   | | |   | | |     | |   |   |   |   |   |
+ +-+ + + +-+-+-+ + + + +-+-+ + + +-+ + +-+-+ + + + +-+ +-+ +-+ +-+-+ + + +-+-+ +-+ + + +-+-+ +-+-+ +
| |   |   |     |   | |   |   | | |   |   | | | | | |     |     |     | |   |   |   | | |     |     |
+ + +-+-+-+-+ +-+-+-+ +-+ + +-+ + + +-+-+ + + + + + + +-+ +-+-+-+-+-+-+ +-+ + +-+ +-+ + + + +-+ +-+-+
|     |   |   |     |   | |   | | |   |   |   | | |   | | |   |         |   | | |     |   |   | |   |
+-+-+ + +-+ +-+ +-+ +-+ + +-+ + + +-+ + +-+-+-+ + +-+-+ + + +-+ +-+ +-+-+-+ + + +-+-+ + +-+-+-+ + + +
|     |       | |   | |   | | |   | | |         | |       |     |           | |   |   | |         | |
+ +-+-+-+-+-+ + +-+-+ +-+-+ + + +-+ + +-+-+-+-+ + +-+ + +-+-+-+-+ + +-+-+-+-+ +-+ + + +-+ +-+-+-+-+ +
|     | |     |       |       | |   |       |   |   | |         | |       |   |   | | |   |   |   | |
+-+-+ + + +-+-+-+ +-+-+-+-+-+-+ + + +-+-+-+ + + +-+ + +-+ +-+-+-+ +-+-+-+ + +-+ +-+ +-+ +-+ + + + +-+
|       |       | |               |   |     | |   | |   | | |       |     |   |   | |   |   |   |   |
+ +-+-+ + +-+-+ + + +-+-+-+-+-+-+-+-+ + +-+-+ + + + +-+-+ + + +-+-+ +-+-+-+-+ +-+ + + +-+ +-+-+-+-+ +
| |     |     |   |   |     |     |   | |     | |   |     |   |   |   | |   |   |   |   |   |     | |
+-+ +-+-+-+-+ +-+-+-+ + +-+-+ + + + +-+ + +-+-+ +-+-+ +-+-+ +-+ + +-+ + + +-+ + +-+-+-+ +-+ + +-+-+ +
|   |   |   |         |       | |   | | | |   |   |   |   |     | | |   |   | | |     |     |     | |
+ +-+-+ + +-+-+ +-+-+-+-+-+-+-+ + +-+ + + + + +-+ + +-+ + + +-+-+ + +-+ +-+ + + + +-+ +-+-+-+-+-+ + +
|       |       |               |     |   | |     |     |   |     |           |   |             |   F 
+-+-+-+-+-+-+-+-+-+-+-+-+-+-+-+-+-+-+-+-+-+-+-+-+-+-+-+-+-+-+-+-+-+-+-+-+-+-+-+-+-+-+-+-+-+-+-+-+-+-+
