+-+-+-+-+-+-+-+-+-+-+-+-+-+-+-+-+-+-+-+-+-+-+-+-+-+-+-+-+-+-+-+-+-+-+-+-+-+-+-+-+-+-+-+-+-+-+-+-+-+-+
S |   |             |     |         |   | |       |     |   |   |   |       |   | |     |       |   |
+ + + +-+-+ +-+-+-+-+ +-+ +-+-+-+-+ + + + + +-+-+ + +-+ + +-+ + + + + +-+ + + + + + +-+ +-+-+ + + + +
| | |     | |   | |   | | |         | | |   |   | |   | |     |   | | |   | | |   |   |   |   | | | |
+ +-+ +-+ + +-+ + + +-+ + + +-+-+-+-+-+ +-+-+-+ + +-+ + +-+-+ +-+-+ + + +-+ + +-+ +-+ + + + +-+ + + +
|   | |   | |       |   |   |         |       | |   | |     |     | | |   |   |   |   | | |   | | | |
+ + +-+ + + + +-+-+-+ +-+-+-+ +-+-+-+ + +-+-+ + +-+ +-+ +-+ +-+ + + +-+-+ +-+-+ +-+-+-+-+ +-+ + +-+ +
| |     | | |     |   |       |       |   |   |   |   | |   |   | |     | |   | |         |   |   | |
+ +-+-+ + + +-+-+ + +-+ +-+-+-+ +-+-+-+-+ + +-+ + +-+ + +-+-+-+-+ +-+-+ + + + + + +-+-+-+-+ +-+-+ + +
| |   | |   |     |   | |       |   |   | |   | | |   |     |     |   |   | | | |   |   |   | |   | |
+ + +-+ + + + +-+-+-+ + + +-+ +-+ + +-+ +-+-+ + +-+ +-+-+-+ + +-+-+ + +-+-+ + + +-+ +-+ + +-+ + +-+ +
|   |   | | |   |   |   |   |     |   |     | |         |     |   | |     | | |     |   | |   |   | |
+ +-+ +-+ + + + + + +-+-+-+ +-+-+-+-+ +-+-+ + + +-+-+-+-+ +-+-+ + + +-+ + +-+ +-+-+-+ +-+ + +-+-+ + +
|   | |   |   |   | |       |   |           | | |         |     |   |   |     |     | |   |   |   | |
+-+-+ +-+-+-+-+-+-+-+ +-+-+-+-+ + +-+-+-+ + + + + +-+-+-+-+ +-+-+-+-+ +-+-+ +-+-+-+ + +-+-+-+ + +-+ +
|     |     |       | |   |   | |     |   | |   |     |   |   |       |     |       |   |   |     | |
+ +-+-+ +-+ + +-+-+ + + + +-+ + +-+-+-+ + + + +-+-+ + + + +-+ + +-+ +-+ +-+-+ +-+-+ + + + + +-+-+ + +
| |       | | |   |     |   | |         | |       | | | |     | | |   | |     | |   | | | |   | | | |
+ + +-+ + + + + + +-+ +-+-+ + +-+-+-+-+-+ +-+ +-+ +-+ + +-+-+-+ + +-+ + +-+ +-+ + +-+-+ + +-+ + + + +
|   |   | |   | | |   |   |   |   |       | | |   |   |   |   | | |   | |     |   |     |   | | | | |
+-+-+ +-+-+-+-+ + + +-+-+ +-+-+-+ + +-+-+-+ + + +-+ +-+-+ + +-+ + +-+ + + +-+-+-+-+ +-+-+-+-+ + + + +
|     |   |   | |   |     |         |   |   | | | |     | |   | |     |     |   |         |   | |   |
+ +-+-+-+ + +-+ +-+-+ +-+ + +-+-+-+-+ + + +-+ + + +-+-+ + + + + +-+-+-+-+ +-+ + + + +-+-+ + +-+ +-+ +
| |       |           | | |   |   | | | |     |     |   | | |   |       | |   | | |   |   |   |   | |
+ +-+-+ +-+-+-+ +-+-+-+ + +-+ + + + + +-+-+-+-+-+ + + +-+ + + +-+ +-+-+ +-+ +-+ + +-+ +-+-+-+ +-+ + +
|     |   |   | |     | |   | | | | |   |   |   | |     | | | |   |     |   |   |   |   |   |       |
+-+ +-+-+ + +-+ + + + + + + + +-+ + +-+ +-+ + +-+ +-+ + + + + + +-+ + +-+ +-+ +-+-+ +-+ + + +-+-+ + +
| |       |     | | |   | | |     | |     | |   | |   |   | |   |   |     | |         | | |   | | | |
+ +-+-+-+ +-+-+-+ + +-+-+-+ +-+-+-+ +-+-+ + +-+ + + +-+-+-+ +-+-+ +-+-+-+-+ +-+-+-+-+-+ + +-+ + + + +
|       | | |     |   | |   |   |   |   |         |   |   | | |   | |     |           |   |     | | |
+-+-+ +-+ + + +-+-+-+ + + +-+ + + +-+ +-+-+ +-+ +-+-+ + +-+ + + +-+ + + +-+-+-+-+-+ + +-+ + +-+-+ + +
|   |     |   |     |     |   | | |   |     | | | |   |   | |   |   | | |   |       |   | |       | |
+ + +-+-+-+ +-+ +-+ +-+-+-+ +-+ + +-+ + +-+-+ + + + +-+ + + +-+-+ + + + + + +-+-+-+-+-+ +-+-+-+-+-+ +
| |   |   |   |   |       | | |     |   |   |   |   |   |   |   | | | |   |   |     |     |   | |   |
+ +-+ +-+ +-+ +-+ +-+-+-+ + + +-+-+ +-+-+ + +-+-+ +-+ +-+-+-+ + +-+ + +-+-+-+ + +-+ + +-+ +-+ + + +-+
|   |   | |     | |   |   | |       |   | |   |   |   |   |   |   |   |     |   | |     |       |   |
+-+ +-+ + + + + + +-+ + +-+ +-+-+-+-+-+ + +-+-+ +-+ +-+-+ + + +-+ + +-+-+-+ + +-+ + + +-+-+-+-+ +-+ +
| |   |     | | |   | |       |     |   |   |   | |   |   | |   |   |       | |   | |   |     |   | |
+ + + +-+ +-+-+ +-+ + +-+-+-+ + +-+ + +-+-+ + +-+ +-+ + +-+-+-+ +-+-+ +-+-+-+-+ +-+ +-+ + +-+ + +-+ +
| | | |   |   |   | | | |     |   |       |   |     | | | |   | |     |   |       | |   |   |     | |
+ + + + +-+ + +-+-+ + + + +-+-+-+ +-+-+-+-+-+-+-+ + + + + + +-+ + +-+-+-+ +-+-+-+ +-+ +-+-+ +-+-+ + +
|   | | | | | |   | | | |   |     |         |     |     |   |   |   |   |   |   |   | |     |   |   |
+-+-+ + + + + + + + + + +-+ + +-+-+ +-+-+-+ + +-+-+-+ +-+-+ + + +-+ + + + + + + + + + +-+-+-+ + +-+-+
| |   | |   |   | | |       |   |   |   | |   |       |   |   |   |   |   |   |   | |         |     |
+ + +-+ + +-+-+-+ + +-+-+-+-+-+ + +-+ + + +-+-+ +-+-+ +-+ +-+-+-+ +-+-+-+-+-+-+-+-+ +-+-+-+-+-+ + +-+
|   |   |     |   |             |     | | |     |   | |   |     | |   |     |     |     |       |   |
+-+-+ +-+-+-+ + +-+ +-+-+ +-+-+-+-+-+-+ + + +-+-+ + +-+ +-+ +-+ +-+ + + +-+ +-+-+ +-+-+ + + +-+-+-+ +
|     |     | |     |   |     | |   |   |   |     | |   |     |   | |   |     |   |   |   |     |   |
+ +-+-+ +-+ + +-+-+ + +-+-+-+ + + + + +-+-+ + +-+-+ + +-+ +-+-+-+ + +-+-+ +-+ + +-+ + +-+-+-+-+-+ +-+
|       |   | |   |   |       | | |   |   |       |   |   |   |   | |   | |   | |   | |   |   |   | |
+-+-+-+-+ +-+ + + +-+-+ +-+-+ + + +-+-+ + +-+-+-+-+-+-+ +-+-+ + +-+ + + +-+ + + + +-+ + +-+ + + +-+ +
|       | |   | | |     |     |   |   | |     |       |       |   |   |   | | | |   |     | | |   | |
+ +-+-+ + + +-+ + + +-+-+ +-+-+-+-+-+ +-+-+ + + +-+-+ +-+-+-+ +-+-+-+-+-+ +-+ + +-+ +-+ + + + +-+ + +
| |     | |   | |   |     |         |   | | | |     |   |   | |         | |       |   | | | |   |   |
+ +-+-+-+ +-+ + +-+-+ +-+-+ + +-+-+ +-+ + + + +-+ +-+-+ + + + + +-+-+-+ + + +-+-+-+-+ + +-+ + + +-+ +
| |       |   |   |   |   | | |   | |     | |   |   |   | | |   | |     | |     |     |     | |     |
+ + +-+ +-+ +-+-+ + +-+ + + + + + + + +-+ +-+-+ +-+ + +-+ + +-+ + + +-+-+ +-+-+ + +-+-+-+-+-+ +-+ +-+
| | | |     | |   |   | |   |   | | | | |   |   |   |   | |   | | |       |   | | |   |       |     |
+ + + + +-+-+ + + +-+ + +-+-+-+-+ + + + +-+ + +-+ +-+-+ + +-+ + + +-+-+ + + +-+ + + + + +-+-+-+ +-+ +
|   | | |   |   | |   |   |   |   | | | |   | |   | |   | |   | |       | | |   |   | |   |     | | |
+-+-+ +-+ + +-+-+ + +-+-+ + + + +-+ + + + +-+ + +-+ + +-+ + +-+-+-+-+-+-+ + + + +-+-+ +-+ + +-+-+ + +
|   |   | |   |   | |   | | |     |   |   |   | | | |     | |   |       | |   |   | | |   |   |   | |
+-+ +-+ + +-+ +-+-+ +-+ + +-+-+-+ +-+-+-+-+ +-+ + + +-+-+-+ +-+ +-+ +-+ + +-+-+-+ + + + +-+-+ + +-+ +
|   |     | |   |   |   |     |   |   |     | | | |       |   | |   |   | |   |       | |     | |   |
+ +-+ +-+-+ +-+ + +-+ +-+-+-+ +-+-+ +-+ +-+-+ + + +-+-+-+ +-+ + + +-+-+-+ + + +-+-+-+-+ + +-+-+ + + +
|   | |     | | |       |   |       |     | | | |     | |     | |         | |         | |     |   | |
+ + + + +-+-+ + +-+-+ + + + +-+-+ +-+ + + + + + +-+-+ + +-+-+-+ +-+-+-+-+-+-+-+-+ + + + +-+ +-+-+-+ +
| | | |     | |   |   | | |     |   | | |   | |   |   |   | |   |             |   | |   |   |       |
+ + + +-+-+ + +-+ + +-+-+ + + +-+-+ + + +-+-+ +-+ + +-+-+ + + + + +-+-+-+-+-+ + +-+-+-+-+ +-+ +-+ +-+
| | | |   |     |         | | |     | | |       | |   | | | | |   |   |     |   | |   | | |   |   | |
+ +-+ + +-+-+ +-+-+-+-+-+-+ +-+ + +-+ + +-+ +-+-+ +-+ + + + + +-+-+ + + +-+ +-+-+ + + + + + +-+ +-+ +
|     |     |   |       |   |   |     | |   |   | |       | | |     | |   | |   | | |     |   |   | |
+ +-+-+-+-+ +-+ + + +-+ + +-+ +-+-+-+-+ + +-+ + + + + +-+ + + +-+-+ + +-+ + + +-+ + +-+-+-+-+ +-+ + +
| |   |   |   |   | |   | |   |   |     | |   |     | |   |         | |   | |   |     |       |   | |
+ + + + + +-+ +-+-+-+ + + + +-+ + + + +-+ + +-+-+ +-+ +-+ +-+-+-+-+-+ + +-+ +-+ + +-+-+ +-+-+-+ +-+ +
|   | | |   |         | |     | |   |     |     |   |   | |     |     | |   |   | |   | |       |   |
+-+-+ + +-+ +-+-+ +-+-+ +-+-+ + +-+-+-+-+-+-+-+-+-+-+-+ +-+ +-+ + +-+-+ + +-+-+ +-+ + + + +-+-+-+ +-+
|   |   | |     | | |   |     | |   |     |   |       |   | |   |       | |   |     |   |       |   |
+ + + +-+ +-+-+ + + + +-+ +-+-+ + + +-+-+ + + + +-+ + +-+ + + +-+ +-+-+-+ + + +-+-+-+-+-+-+-+-+ + +-+
| | | |   |     |   |     |     | | |     | | |   | |       | |   | |   |   | |   |   |         |   |
+ +-+ + +-+ +-+-+-+-+-+-+-+ + +-+ + + +-+-+ + +-+ +-+-+-+-+-+-+ +-+ + +-+-+-+ + + + +-+ +-+-+-+-+-+ +
|     |     | |         |   | |   |   |   | |   |               | | |   | |     | |   |   |   |     |
+-+-+-+-+-+-+ + +-+-+-+ + +-+-+ +-+-+-+ + + + + +-+-+-+-+-+-+-+-+ + +-+ + + +-+-+ +-+ +-+ + + + +-+ +
|     |   |   |   |   |   |     |   |   |   | |   |     |     |   | |     |     | |   |   | | |   | |
+ +-+-+ + + +-+-+ + + +-+-+ +-+-+-+ + +-+-+-+-+-+ + +-+ + +-+ + + + + +-+-+ +-+ + + +-+ + + + +-+ + +
|   |   |         | | |             | |   |   | | | |     | | | |   |       | | | | | | |   | |   | |
+-+ + +-+-+ +-+ +-+-+ + +-+ +-+-+-+-+ + + +-+ + + + +-+-+-+ + + + +-+-+-+-+-+ + + + + + +-+ + + +-+ +
|   |     |   |     |     |         | | |     |     |       |   | |     |   | | | |     |   |   |   |
+ + +-+-+ +-+ +-+-+ +-+ +-+ +-+-+ + + + +-+-+-+-+ +-+ +-+ +-+ +-+-+ +-+ +-+ + + +-+-+-+-+-+-+-+-+ +-+
| |   |   |   |   |   |   |   |   | | | |         | | |   |   |   | | |       | |   |           |   |
+ +-+-+ +-+ +-+ +-+ + +-+ +-+-+ +-+-+ + + +-+ + +-+ + +-+-+ +-+ + + + +-+-+-+-+ + + + +-+-+-+-+ +-+ +
|       | |     |   |   |   |     |   |   |   | |   |     |     |   |           | | |     |   |   | |
+-+-+-+-+ +-+-+ + +-+-+ +-+ + +-+-+ + +-+-+ +-+ + +-+-+-+ +-+-+-+ +-+ +-+ +-+-+-+ + +-+-+ + + +-+ + +
|     |       | |   |   |   |   |   |   |   |   |   |           | |   |   |       |     | | | |     |
+ +-+ +-+ + + +-+-+ +-+-+ +-+-+ + +-+ +-+ +-+ +-+-+ + +-+-+-+-+ +-+ +-+-+-+ + +-+-+-+-+ + + + +-+-+-+
| | |     | |     |   |   |   |     |   |   |     | |   |   | |     |       | |     | | | | |       |
+ + +-+-+ + +-+-+ +-+ + +-+ + +-+-+-+-+ +-+ +-+-+ + +-+ + + + +-+-+-+-+-+-+ + + +-+ + + + + +-+-+-+ +
| |   |   |   | |   |   |   |   |       |     | | |   | | | |       |     | | | |   |     | |     | |
+ +-+ + +-+-+ + +-+ + +-+ +-+-+ + +-+-+-+-+-+ + + +-+ +-+ + +-+ +-+ + +-+ + + + + +-+-+-+-+ + +-+-+ +
|     |     |   |       |     |   |             |         |     |   |   |   |   |           |       F
+-+-+-+-+-+-+-+-+-+-+-+-+-+-+-+-+-+-+-+-+-+-+-+-+-+-+-+-+-+-+-+-+-+-+-+-+-+-+-+-+-+-+-+-+-+-+-+-+-+-+