+--+--+--+--+--+--+--+--+--+--+--+--+--+--+--+
      |        |      |                    |
+--+  +  +--+  +--+--+  +  +--+--+--+--+--+  +
|     |  |                 |              |  |
+  +--+  +  +  +--+--+  +--+  +--+--+--+  +  +
|  |  |  |  |  |        |  |  |     |  |     |
+  +  +  +  +  +  +--+--+  +  +  +  +  +--+--+
|  |     |  |  |        |  |     |     |     |
+  +--+  +--+  +--+--+  +  +--+--+--+--+  +  +
|        |     |        |  |  |           |  |
+--+--+--+  +  +  +--+--+  +  +  +--+--+--+  +
|     |     |  |     |        |           |  |
+  +  +  +--+--+--+  +  +  +  +  +  +--+  +--+
|  |  |  |  |        |  |  |  |  |     |     |
+  +  +  +  +  +--+--+  +  +  +  +--+  +--+  +
|  |  |     |           |  |     |     |     |
+  +--+  +--+--+--+--+--+--+--+--+--+--+  +--+
|  |     |     |             S            |  |
+  +  +  +  +--+  +--+--+--+--+  +--+--+--+  +
|     |  |  |     |     |     |  |     |     |
+  +--+  +  +  +--+  +  +  +--+  +  +  +  +--+
|  |     |  |  |     |  |     |     |        |
+  +  +--+  +  +  +--+  +--+  +--+--+--+--+--+
|  |     |     |     |     |           |     |
+  +--+--+--+--+--+--+--+  +--+  +  +--+  +  +
|        |     |     |           |     |  |  |
+--+--+  +  +  +  +  +  +--+  +--+--+  +  +--+
|        |  |  |  |        |        |  |     |
+  +--+--+  +  +--+--+--+  +--+--+  +  +--+  +
|           |              |        |        F
+--+--+--+--+--+--+--+--+--+--+--+--+--+--+--+